
NO ./assets/texture/north.png
SO ./assets/texture/south.png
WE ./assets/texture/west.png
EA ./assets/texture/east.png

C 168,207,247
F 0,50,0

        1111111111111111111111111
        1000000000110000000000001
        1011000001110000000000001
        1001000000000000000000001
111111111011000001110000000000001
100000000011000001110011111111111
11110111111110011100000010001
11110111111110011101000010001
10010000110100011100001010001
101000000000000030000011000001
11000E00000000003001010010001
110000011100000111110111100111
11110111 1100001 101111010001
11111111 1111111 111111111111