
NO ./assets/texture/north.png
SO ./assets/texture/south.png
WE ./assets/texture/west.png
EA ./assets/texture/east.png
        
F 255,30,00
C 225,30,0000000000000000000000000000100

111111
100101
101001
110N01
111111