NO ./assets/texture/north.png
SO ./assets/texture/south.png
WE ./assets/texture/west.png
EA ./assets/texture/east.png

F 220,100,0
C 225,30,0

                                1111111111111
             1111111111         1100000000011
            110000000111        1000000000001
11111111111111000000001111111111110011111111111111
                                             11  1
                                                 1
                                                 1
                                                 1
                                               111
                                     1111111111111
                                            111
                                             11
                                          11111
                                     1111111111
                                     11
                                     11