NO ./assets/texture/north.png
SO ./assets/texture/south.png
WE ./assets/texture/west.png
EA ./assets/texture/east.png

C 168,207,247
F 0,50,0

                                    1111111111111
                 1111111111         1100000000011
                110000000111        1000000000001
    11111111111111000000001111111111110011111111111111
    10000000000000000000000000000000000000000000011001
    10000000000000000000000000000000000000000000000001
    10000000000000000000000000000000000000000000000001
    10000000000000000000000000000000000000000000000001
    10000000000010000000000000000000000000000000000111
    10000111111111000111111111111110000001111111111111
    1000000000100100011          110000000000000111
    1000000000000100001          100000000000000011
    1100000000011100001          100000000000011111
    1111110000011100001          100000000000011111
        110000010000001          110000001111111111
         10000010000001          1110000011
         10000010000001          111000001111111111111111111
         11000010000001          100000001110000100000000001
         11000010000001          100000000110000300000000001
         11000010000001          110000000000000300000000001
         11000010000001           11000000000000100000000001
         1000001011111111111111    1111111111111100000000001
         1000000000000100100011              111100000000001111111111
         1000000000000000100001              100000000000001000000001
         1000000000000000000001              100000000000000000000001
         1000111100000000000001              100000000000000000000001
         1111111111111111111001              100000000000000000000001
            1000000001     1001              100001111111111110000001
            1000000001    11001              1000011        110000001
            1110000001    110011            1100001          101000011
              11000001    1000111111111111111100001          1010000111
               1110011    1000000000000000000000001          1010000001
               1110001    1000000000000000000000001          1010000001
            111100000111111111111111111100000000001          1010000001
         1111000000000000010110000000000000000000111        11010000001
         11110000000000000301100000000000000000000111111111111010000001
         11110000000000000300000000000000000000000000000000000010000001
         1111000000000000010000000000000000000000000000110000001000W001
         11110000000011111111001111111111111100000011111111111110000001
         11100000000111    100001          1110000111          10000001
         1100000000011     100001           11000011           10000001
         100000000001      100001            111111            10000001
         110011100001      100001                              10000001
         111001000001      100011                         1111111000111
         111000000001      100001                         1001110000001
         111000000111      1000011111                     1100110000001
         111000000111      1000000001                     1100000000011
         100000000011      1100000001                     1100000000011
         100000000001      1100011101                     1100000000011
        110111111331111    1111110001   1111111111111111111000000000011
       10100000000000001       100001   1000000000001111100000000000001
      1000100000000000001      100001   1000000000000010000000000000001
      100000000000000000011    1000011  1000000000000010000000000000001
      100000000000000000101   11000001111000000000000010000000000000001
      100000100000000000001  111000000000000000000000011100000000000011
      110000000000000000111  100000000000000000000000011110000000000011
     111111111110000000011   100000001111000000000000011111111111000011
1111111000000111000000011    100000111  1100000000000000000000000000011
111110000000000000000000111111000011     100000000000000000000000000001
11111000000000000000000000000000001      111000000000000000000000000001
11100000100001000000000000000000001      111000000000000000000000000001
11110001111011000000000011111111001      111111111111111111111111000001
1111111111111111111111111    111001                          1000000001
                             111111                          1000000001
                                                             1111111111